6
5
*-*** 
**--* 
**--* 
***-* 
*---* 
***-*